R 1000 1000
NO ./textures/1.xpm
WE ./textures/2.xpm
SO ./textures/3.xpm
EA ./textures/4.xpm
S ./textures/sprite.xpm
F 49,100,0
C 135,206,235


                                                                                                       1
                                                                                                      111
                                                                                                     11011
                                                                                                    1100011
                                                                                                   110000011
                                                                                                  11000000011
                                                                                                 1100000000011
                                                                                                110000000000011
1                                                                                              11000000000000011
11   1   1   1   1   1   1   1   1   1   1   1   1   1   1   1   1   1   1   1   1   1        1100000000000000011   1   1
101 101 101 101 101 101 101 101 101 101 101 101 101 101 101 101 101 101 101 101 101 101      110000000020000000011 101 101
1001000100010001000100010001000100010001000100010001000100010001000100010001000100010001    11000000110001100000001000100011
10000000000000000000000000000000000000000000000000000000000000000000000000000000000000001  110000001  101  10000000000000001
100000000000111100011000011001111110011111111001111111111001111100011000011000111111000001 1000000001  1  100000000000000001
100000000001    101  1001  101    101       101         101     101  1001  101      100000100000000001   1000000000000000001
100000000001   1101  1001  101  11101  11111001   111   101  111101  1001  10011  110000000000000000001 10000000000000000001
100000000001  10001  1001  101  10001  10000001   101   101  100001  1001  10001  100111001110111011100100111001110000000001
100000000001  10001  1111  101  11101  10000001   111   101  111001  1111  10001  100101000010001010100000100101000000000001
100000000001  10001        101    101  10111101         101     101        10001  100001001110111000101110111001011100000001
100000000001  10001  1111  101  11101  101  101  11111  1001111 101  1111  10001  100001000010001000100000100101001000000001
100000000001  10001  1001  101  10001  1001 101  10001  1000001 101  1001  10001  100011101110111000100200111001110000000001
100000000001   1101  1001  101  11101  1111 101  10001  1011111 101  1001  10011  110000000000000000002120000000000000000001
100000000001    101  1001  101    101       101  10001  101     101  1001  101      1000000000000000021112000000000000000001
1000000000011110001100011100111111001111111000110000111000111110000110000110001111110000000000000000211 11200000000000000001
100000000000000000000000000000000000000000000000000000000000000000000000000000000000000000000000000211   1120000000000000001
10000011001100111110001100000011001111011111100011000000011001111000011110000110011001111110000000211     112000000000000001
10000110011000000110011110000110011000000110000110000000110011  110011  1100110011001100000000000211   1   11200000000000001
1000110011000000110011011000110011000000110000110000000110011  110011  1100110011001100000000000211   1 1   1120000000000001
100111111000111100011001100110011110000110000110001100110011  110011111100111111001111100000000211   1   1   112000000000001
10000011001100000011000110110011000000110000110001100110011  1100110110001101100000001100000000211  1     1  112000000000001
1000011001100000011000011110011000000110000011001100110011  11001100110011001100000011000000000211   1   1   112000000000001
10001100011111001100000111001111000011000000011100111000011110011000110110001101111100000000000211    1 1    112000000000001
10000000000000000000000000000000000000000000000000000000000000000000000000000000000000000000000211     1     112000000000001
10000000000000000000000000000000000000000000000000000000000000000000000000000000000000000000000211           112000000000001
1111111111111111111111111111111111111111111111111111111111111111111111111111111111111111111111111111111111111111111111111111
