R  1800 1600
NO textures/purplestone.xpm
SO textures/bluestone.xpm
WE textures/1.xpm
EA textures/eagle.xpm
S sprite_4.xpm
F 110,100,0
C 115,30,0

    1111111111111111111111111
    1000001000110000100000001
    1011000001110000000000101
    10010000000000000000000011111
11111111101100000111000000000001
1000010000110000011101111111111111
11110111111111011100000010001
11110111111111011101010010001
110000001101020011100000010001
10000100000000001100000010001
1001000000000N101101010010001
1100000111000001111101111001111
 11110111 1110101 10111101001
 11111111 1111111 111111111111