R  2500 2500
NO textures/purplestone.xpm
SO textures/bluestone.xpm
WE textures/1.xpm
EA textures/eagle.xpm
S textures/sprite_4.xpm
F 220,200,0
C 115,30,0

1111111111111111111111111
1000000000000000000000001
1000000000000000000000001
1000001000010000100000001
1000000000000010000000001
1000000001000000000000001
1000000010001010100000001
1000000000101010000000001
1000000100000000010000001
1000000001010001000000001
1000000000000000100000001
10000000000000N0000000001
1000000000000000000000001
1000000000000000000000001
1111111111111111111111111
