
R 1100 1100

        NO textures/7.xpm
                SO textures/8.xpm
                        WE textures/9.xpm
                        EA textures/15.xpm
                S  textures/s.xpm
        F       202,161,22  
  C       119,181,245
 
     1   1   1   1   1   1   1   1   1   1   1   1   1   1   1   1   1   1   1   1   1   111111111111
    101 101 101 101 101 101 101 101 101 101 101 101 101 101 101 101 101 101 101 101 101 1000000000000111111111
   10001000100010001000100010001000100010001000100010001000100010001000100010001000100010000110001100000000001
  100000000000000000000000000000000000000000000000000000000000000000000000000000000000000001  101  10000000001
 10011110001100001100011110001111111000111111111000111110001100001100011111100000000000000001  1  100000000021
1001    101  1001  101    101       101         101     101  1001  101      100000000000000001   1000000000001
1201   1101  1001  101  11101  11111001   111   101  111101  1001  10011  110000000000000000001 10000000000021
1001  10001  1001  101  10001  10000001   1 1   101  100001  1001  10001  100111001110111011100100111101110001
1201  10001  1111  101  11101  10000001   111   101  111001  1111  10001  100101000010001010100000100101000001
1001  10001        101    101  10111101         101     101        10001  100001001110111000101110111001011101
1201  10001  1111  101  11101  101  101  11111  1001111 101  1111  10001  100001000010001000100000100101001001
1001  10001  1001  101  10001  1001 101  10001  1000001 101  1001  10001  100011101110111000100000111001111021
1201   1101  1001  101  11101  1111 101  10001  1011111 101  1001  10011  100000000000000000000000000000000001
1001    101  1001  101    101       101  10001  101     101  1001  101     11000202020202020202020202020202021
12001111000110001110001111000111111100011000011100011111000110000110001111110002111111111111111111111111111111   
120000000000000000000000000000000000000000000000000000000000000000N20000000000021
 1200000000000000000000000000000000000000000000000000000000000000000000000000021
  12000000000011001101111001000101110111010001001001110010010011110000000000001  
   120000000011001100000110110010100001001000101 10101001010011000000000000001 
    10000000110011000001100101010111001001010101 1011000110000110000000000021   
     1200001111110011111000100110100001001101101 101010010100001111100000001     
      120000001100110000000100010111001000101000100100101001000000011000021  
       1200001100011000000000000000000000000000000000000000000000001100001    
        12001100001111111111111111111111111111111111111111111111111110021    
         100000000000000000000000000000000000000000000000000000000000001
          1020202020202020202020202020202020202020202020202020202020221  
           11111111111111111111111111111111111111111111111111111111111