R  500 500
NO textures/4.xpm
SO textures/6.xpm
WE textures/7.xpm
EA textures/8.xpm
S textures/sprite_4.xpm
F 202,161,82
C 119,181,245

1111111111111111111111111
1111111111121111111111111
1200000000000000000000201
1000000000000000000000001
1000000000000000000000001
1000000000000000000000001
1000000000000000000000001
1000000000000000000000001
1000000000000000000000001
1000000000000000000000001
1000000000000000000000001
1000000000000000000000001
1001000000000000000000001
10000000000N0000000000001
1111111111111111111111111
