R  0900 800
NO textures/4.xpm
SO textures/6.xpm
WE textures/7.xpm
EA textures/8.xpm
S textures/sprite_4.xpm
F 202,161,82
C 119,181,245

1111111111111111111111111
1111111111101111111111111
1000000000000000000000001
1000002000000000000000001
1000000000000000000000001
1000000000000000000000001
1000000000000010000000001
1000N00000000020000000001
1000000000000010000000001
1000000002000000000000001
1000000000000000000002001
1000000000000000000000001
1000000000000000000000001
1000000000000000002000001
1111111111111111111111111
