R  2500 2500
NO textures/4.xpm
SO textures/6.xpm
WE textures/7.xpm
EA textures/8.xpm
S textures/sprite_4.xpm
F 202,161,82
C 119,181,245

1111111111111111111111111
1000000000000000000000001
1200000000000000000000001
1000000000000000000000001
1000000000000000000000001
1000000000000000000000001
1000000000000000000000001
1000000000000000000000001
1000000000000000000000001
1000000000000000000000001
1000000000121000000000001
1000000000000000000000001
1000000000000000000000001
10000000000N0000000000221
1111111111111111111111111
