R      800 600
NO textures/purplestone.xpm
SO textures/bluestone.xpm
WE textures/1.xpm
EA textures/eagle.xpm
S path_to_the_sprite_texture
F 220,100,0
C 225,30,0

    1111111111111111111111111
    1000002000110000200000001
    1011000001110000000000201
    10010000000000000000000011111
11111111101100000111000000000001
1000020000110000011101111111111111
11110111111111011100000010001
11110111111111011101010010001
110000001101010011100000010001
10000200000000001100000010001
1002000000000N201101010010001
1100000111000001111101111002111
 11110111 1110101 10111101001
 11111111 1111111 111111111111