R 1000 100000
NO ./textures/1.xpm
WE ./textures/2.xpm
SO ./textures/3.xpm
EA ./textures/4.xpm
S ./textures/sprite.xpm
F 49,100,0
C 135,206,235

                                                                                                    
                                                                                                          
11   1   1   1   1   1   1   1   1   1   1   1   1   1   1   1   1   1   1   1   1   1        1 1 1111111111 1 1 
101 101 101 101 101 101 101 101 101 101 101 101 101 101 101 101 101 101 101 101 101 101      10101000000000010101
1001000100010001000100010001000100010001000100010001000100010000000100010001000100010001    100001100011000000001
100000000000000000000000000000000000000000000000000000000000000000000000000000001  10000001  101  10000000000001
100111100011000011000111100011111110001111111110001111100011000011000111111000001 1000000001  1  10000000000001
101    101  1001  101    101       101         101     101  1001  101      100000100000000001   10000000000001
101   1101  1001  101  11101  11111001   111   101  111101  1001  10011  110000000000000000001 10000000000001
101  10001  1001  101  10001  10000001   1 1   101  100001  1001  10001  10011100111011101110010011100111001
101  10001  1111  101  11101  10000001   111   101  111001  1111  10001  100101000010001010100000100101000001
101  10001        101    101  10111101         101     101        10001  1000010011101110001011101110010111001
101  10001  1111  101  11101  101  101  11111  1001111 101  1111  10001  10000100001000100010000010010100100001
101  10001  1001  101  10001  1001 101  10001  1000001 101  1001  10001  10001110111011100010020011100111000001
101   1101  1001  101  11101  1111 101  10001  1011111 101  1001  10011  110000000000000000002120000000000000001
101    101  1001  101    101       101  10001  101     101  1001  101      10000000000000000000000000000000000001
10111100011000111000111100011111110001100001110001111100011000011000111111000000000000000000002011120000000000001
10000000000000000000000000000000000000000000000000000000000000000011   11200000000000000000000011 110000000000001
100001100110011111000110000001100111101111110001100000001100111100001111000011001100111111000211   11200000000001
1000110011000000110011110000110011000000110000110000000110011  110011  11001100110011000000211   1  1120000000001
100110011000000110011011000110011000000110000110000000110011  110011  11001100110011000000211   1 1   11200000001
10111111000111100011001100110011110000110000110001100110011  1100111111001111110011111000211   1   1   1120000001
1000011001100000011000110110011000000110000110001100110011  11001101100011011000000011000211  1     1  1120000001
100011001100000011000011110011000000110000011001100110011  110011001100110011000000110000211   1   1   1120000001
10011000111110011000001110011110000110000000111001110000111100110001101100011011111000000211    1 1    1120000001
10000000000000000000000000000000000000000000000000000000000000000000000000000000000000000211     1     1120000001
11111111111111111111111111111111111111111111111111111111111111111111111111111111111111111111111111111111111111111