R 1920 1080
NO ./textures/1.xpm
WE ./textures/2.xpm
SO ./textures/3.xpm
EA ./textures/4.xpm
S ./textures/sprite.xpm
F 49,100,0
C 135,206,235


 1   1   1   1   1   1   1   1   1   1   1   1   1   1   1   1   1   1   1   1   1   1   11111 1111   1   1
101 101 101 101 101 101 101 101 101 101 101 101 101 101 101 101 101 101 101 101 101 101 100000100001 101 101
1001000100010001000100010001000100010001000100010001000100010000000100010001000100010001000110001100100010001
1000000000000000000000000000000000000000000000000000000000000000000000000000000000000000001  101  10000000001
10011110001100001100011110001111111000111111111000111110001100001100011111100000000000000001  1  100000000001
101    101  1001  101    101       101         101     101  1001  101      100000000000000001   1000000000001
101   1101  1001  101  11101  11111001   111   101  111101  1001  10011  110000000000000000001 10000000000001
101  10001  1001  101  10001  10000001   1 1   101  100001  1001  10001  100111001110111011100100111101110001
101  10001  1111  101  11101  10000001   111   101  111001  1111  10001  100101000010001010100000100101000001
101  10001        101    101  10111101         101     101        10001  100001001110111000101110111001011101
101  10001  1111  101  11101  101  101  11111  1001111 101  1111  10001  100001000010001000100000100101001001
101  10001  1001  101  10001  1001 101  10001  1000001 101  1001  10001  100011101110111000100000111001111001
101   1101  1001  101  11101  1111 101  10001  1011111 101  1001  10011  110000000000000000001000000000000001
101    101  1001  101    101       101  10001  101     101  1001  101      1000000000000000011100000000000001
100111100011000111000111100011111110001100001110001111100011000011000111111000000000220000011 110000000000001
10000000000000000000000000000000000000000000000000000000000000000000000000000000000000000011   11000000000001
1000011001101111001100010111011101000100100111001011001111000000000000000000000002200000011  1  1100000000001
1000110011000001101110010100001001000101 1010100101001100000000000000000000000000200000011  1 1  110000000001
1001100110000011001011010111001001010101 101100011000011000000000000000000000000200000211  1   1  11200000001
1011111100111110001001110100001001101101 10111001010000111110000000000000000000000000211  1     1  1120000001
10000110011000000010001101110010001010001001011010110000000110000000000000000000000000211  1   1  11200000001
100011000110000000000000000000000000000000000000000000000001100000000000000000000000000211  1 1  112000000001
1001100001111111111111111111111111111111111111111111111111111000000000000000000000000000011  1  1120000000001
 1000000000000000000000000000000000000000000000000000000000000000000000000000000000000000011   11000000000001
  11111111111111111111111111111111111111111111111111111111111111111111111111111111111111111111111111111111111