R 1920 1080
NO ./textures/1.xpm
WE ./textures/2.xpm
SO ./textures/3.xpm
EA ./textures/4.xpm
S ./textures/sprite.xpm
F 49,100,0
C 135,206,235


     1   1   1   1   1   1   1   1   1   1   1   1   1   1   1   1   1   1   1   1   1   11111 1111   1   1
    101 101 101 101 101 101 101 101 101 101 101 101 101 101 101 101 101 101 101 101 101 100000100001 101 101
   1000100010001000100010001000100010001000100010001000100010000000100010001000100010001000110001100100010001
  10000000000000000000000000000000000000000000000000000000000000000000000000000000000000001  101  10000000001
 1011110001100001100011110001111111000111111111000111110001100001100011111100000000000000001  1  100000000001
101    101  1001  101    101       101         101     101  1001  101      100000000000000001   1000000000001
101   1101  1001  101  11101  11111001   111   101  111101  1001  10011  110000000000000000001 10000000000001
101  10001  1001  101  10001  10000001   1 1   101  100001  1001  10001  100111001110111011100100111101110001
101  10001  1111  101  11101  10000001   111   101  111001  1111  10001  100101000010001010100000100101000001
101  10001        101    101  10111101         101     101        10001  100001001110111000101110111001011101
101  10001  1111  101  11101  101  101  11111  1001111 101  1111  10001  100001000010001000100000100101001001
101  10001  1001  101  10001  1001 101  10001  1000001 101  1001  10001  100011101110111000100100111001111001
101   1101  1001  101  11101  1111 101  10001  1011111 101  1001  10011  100000000000000000001 10000000000001
101    101  1001  101    101       101  10001  101     101  1001  101      100211110000011111   1111100001111
1001111000110001110001111000111111100011000011100011111000110000110001111110021    10001             10001
 100000000000000000000000000000000000000000000000000000N0000000000000000000021      10001           10001
  100000000001100110111100100010111011101000100100111001001001111000000000021        10001         10001
   10000000011001100000110110010100001001000101 1010100101001100000000000021          10001       10001
    1000000110011000001100101010111001001010101 101100011000011000000000001            10001     10001
     100001111110011111000100110100001001101101 10101001010000111110000021              10001   10001
      1000000110011000000010001011100100010100010010010100100000001100001                10001 10001
       10000110001100000000000000000000000000000000000000000000000110001                  100010001
        100110000111111111111111111111111111111111111111111111111111001                    1000001
         1000000000000000000000000000000000000000000000000000000000001                      10001
          11111111111111111111111111111111111111111111111111111111111                        111